103 1 s 2
105 1 s 2
405 1 s 2
346 1 s 2
226 1 s 2
156 1 s 2
146 1 s 2
127 1 s 2
123 1 s 2
111 1 s 1
109 1 s
245 5
