111 3 1
112 3 1
113 3 1
114 3 1
115 3 1
116 3
117 5