205 1 l 1
206 1 l 1
207 1 l 1
208 1 l 1
209 1 l 1
210 1 l 1
211 1 l 1
212 1 l 1
213 1 l 1
214 1 l 1
220 1 l
222 5