110 1 m 1
111 1 m 1
112 1 m 1
113 1 m 1
114 1 m 1
115 1 m 1
116 1 m 1
117 1 m 1
118 1 m 1
119 1 m 1
220 1 m
422 5